5
Q 0 0 0 0
0 0 0 0 0
0 0 0 0 0
0 0 0 0 0
1 T 0 0 0