5
K 0 0 0 0
0 0 0 T 0
0 0 0 0 0
0 0 0 K 0
0 0 0 0 0