6
0 0 0 0 0 0
0 0 0 0 B 0
0 H 0 0 0 0
0 0 0 0 0 0
0 0 0 0 Q 0
1 0 0 0 0 0