5
0 0 0 0 0
0 B 0 0 0
0 0 K 0 0
0 0 0 0 0
1 0 0 0 0