5
1 1 1 0 0
1 T 1 0 0
1 0 1 1 1
1 K 0 0 0
1 0 0 0 0