6
0 0 Q 0 0 0
0 0 0 0 0 T
0 0 0 0 0 0
0 0 0 0 K 0
0 0 0 0 0 0
1 0 0 0 0 0