6
0 0 0 0 0 0
0 0 0 0 0 0
0 0 0 0 0 0
T 0 0 H 0 0
0 0 K 0 0 0
1 0 0 0 0 0